XXXXXXXXXXXXXXXXXXXXXXXXX
X.......................X
X.X.X.X.X.X.X.X.X.X.X.X.X
X.......................X
X.X.X.X.X.X.X.X.X.X.X.X.X
X.......................X
X.X.X.X.X.X.X.X.X.X.X.X.X
X.......................X
X.X.X.X.X.X.X.X.X.X.X.X.X
X.......................X
X.X.X.X.X.X.X.X.X.X.X.X.X
X.......................X
X.X.X.X.X.X.X.X.X.X.X.X.X
X.......................X
X.X.X.X.X.X.X.X.X.X.X.X.X
X.......................X
X.X.X.X.X.X.X.X.X.X.X.X.X
X.......................X
X.X.X.X.X.X.X.X.X.X.X.X.X
X.......................X
X.X.X.X.X.X.X.X.X.X.X.X.X
X.......................X
X.X.X.X.X.X.X.X.X.X.X.X.X
X.......................X
XXXXXXXXXXXXXXXXXXXXXXXXX